12 14
221111111112x1
XXx11133311xX1
22111133311111
111xXXxxxx111X
1x1x22222x111x
121X2xxx2X1221
121X2X1X2X1331
1x1X2X222X1221
@X1X2xxxxX1111
111X22222211X1
111xxxxXXX12x1
22311112111111
80 80
8 0 1