8 9
xX1221x12
@1112111X
Xxx111x11
X113XX1X1
11113X11X
13311311x
111112211
1X1x11111
120 120
1 0 1
