8 9
120 120
xX1221x12
11112111X
Xxx111x11
X113XX1X1
11113X11X
13311311x
111112211
1X1x1111@